WWWWWWWWWWWWWWWWWWWWWWWWW
W.......................W
W....E.............W....W
W..................W....W
W...P..............W....W
W...............W.......W
W......WWWW.....W.......W
W.......................W
W.......................W
W.......................W
W.......................W
W.....WWWWWW............W
W.......................W
W..T....................W
WWWWWWWWWWWWWWWWWWWWWWWWW