WWWWWWWWWWWWWWWWWWWWWWWWW
W.......................W
W...............E..W....W
W..................W....W
W.......W..........W....W
W.......W.......W.......W
W......WWWW.....W.....T.W
W.......W...............W
W.......W...............W
W.......W...............W
W.......W...............W
W...E.WWWWWW......WWWWWWW
W.......................W
W.P.....................W
WWWWWWWWWWWWWWWWWWWWWWWWW