WWWWWWWWWWWWWWWWWWWWWWWWW
W.......................W
W....C.............W....W
W..................W....W
W..P...............W....W
W...............C.......W
W.......................W
W.......................W
W..T....................W
WWWWWWWWWWWWWWWWWWWWWWWWW