WWWWWWWWWWWWWWWWWWWWWWWWW
W.....................P.W
W....C.............W....W
W..................W....W
W..................W....W
W...............C.......W
W.......................W
W.......................W
W..T....................W
WWWWWWWWWWWWWWWWWWWWWWWWW