WWWWWWWWWWWWWWWWWWWWWWWWW
W.......................W
W....W.W..WWW..W..W.....W
W....W.W..W.W..W..W.....W
W.....W...W.W..W..W.....W
W.....W...WWW..WWWW.....W
W.......................W
W.......................W
W...W...W..WWW..WW..W...W
W...W.W.W...W...W.W.W...W
W...W.W.W...W...W..WW...W
W....W.W...WWW..W...W...W
W.......................W
W.......................W
WWWWWWWWWWWWWWWWWWWWWWWWW